{
    "floor_color": [15,5,5],
    "ceil_color": [35,5,5],
    "map": [
        [1,1,1,1,1,1,1,1,1,1,1,1],
        [1,0,0,0,0,0,0,0,0,0,0,1],
        [1,0,0,0,0,0,0,0,0,0,0,1],
        [1,0,0,0,0,0,0,0,4,3,0,1],
        [1,0,0,0,0,0,0,0,3,3,0,1],
        [1,0,0,0,0,0,0,0,0,0,0,1],
        [1,0,0,0,0,0,0,0,0,0,0,1],
        [1,0,0,0,0,0,0,0,0,0,0,1],
        [1,0,0,0,0,2,0,0,0,0,0,1],
        [1,0,2,2,2,2,0,0,0,0,0,1],
        [1,0,0,0,0,0,0,0,0,0,0,1],
        [1,1,1,1,1,1,1,1,1,1,1,1]
    ],
    "enemies": [
        [10, 8], [10, 5], [10, 2], [10, 3]
    ]
}